NO ./textures/jan.png
SO ./textures/jan.png
WE ./textures/jan.png
EA ./textures/jan.png

C 0,0,0
F 255,255,255



11111111111111111111
100000000000000000011111111
10000000000000000000000001111111111111111111
10000001000000000001000000010000000001111011
1000000000000000000100100010111110001111101111111111111111
1000000000000000000100000000000000000000000000000000000011
1111111111100000000111111111111111111000111111000000011111
11110000000000000001                1000111111000011111101111111
10W00000000000000001                11011    1100111111000000011       111
11111111111101111111                1101      1011    100111111        101
           101                       101      101    11011             101
           101                       111      101   1100011            101
           101                                101  110000011           101
           101                                101 11000000011          101
           101                                1011100001100011         1011
           101                                100000111010011          100111111111111
           10111111111                        10000000000001           100000000000001
           10000000001                        11111111111111           111111111111001
           11111111001                                                            1001
                  1011                                                            1001
                  1011                                                            1001
                  1011                                                            1001
                  1011                                                            1001
                  1011                                                            1001
                 11001                                                            1001
                110001                                                            1001
          111111110001                                                            1001
      1111100000000011                                                            1001
    11100000000011111                                                             1001
   110000111111011                                                                10011111111111
   1000111    1001111                                                             10000000000001
   100101     10000011                                                            10100011010101
 11101101     111110011111                                                        10111110000011
110000001         1100000111                                                    11101   1110011
100011111          1111100011                                                  110001     1101111111111111111111111111111111
10111                  1110011                                                1100111      100000000000000000000000000000001
101                      11011                                               110011        111111111111111111111111111111111
101                       10011                                             110011
101                       110011                                           110011
111                        110011                                         110011
                            110011                                       110011
                             110011                                     110011
                              110011                                   110011
                               110011                                 110011
                                110011                               110011
                                 110011                             110011
                                  110011                           110011
                                   110011                         110011
                                    110011                       110011
                                     110011                     110011
                                      110011                   110011
                                       110011                 110011
                                        110011               110011
                                         110011             110011
                                          110011           110011
                                           110011         110011
                                            110011       110011
                                             110011     110011
                                              110011   110011
                                               110011 110011
                                                11001110011
                                                 110000011
                                                  1100011
                                                   11011
                                                    111