NO ./textures/jan.png
SO ./textures/geelmuurtje.png
WE ./textures/jan.png
EA ./textures/jan.png

F 0,0,0
C 255,0,255



11111111111111111111
10000000001000000001
10000000001211101221
10000001001010121001
10000000001212101001
10000000000000101001
11111111111111121111
11110000000000000001
10W00000000000000001
11111111111111111111
