NO ./textures/roodmuurtje.png
SO ./textures/roodmuurtje.png
WE ./textures/roodmuurtje.png
EA ./textures/roodmuurtje.png

F 0,0,0
C 255,0,255



11111111111111111111111111111111111111111111111111111111111111111111111111111111111111111
10000000000000000001111111100000000000000111111110000000000000000000000000000000000000001
10000000001100000001111111100000000000000111111110000000000000000000000000000000000000001
10000000001100000001111111100000000000000111111110000000000000000000000000000000000000001
10000000001100000001111111100000000000000111111110000000000000000000000000000000000000001
11111111111100000001111111101111111111110111111110000000000000000000000000000000000000001
11111111111100000001111111101111111111110111111110000000000000000000000000000000000000011
11111111111100000001111111101111111111110111111110000000000000000000000000000000000000011
10000000000000000000111111101111111111110111111100000000000000000000000000000000000000001
10000000000000000000011111101111111111110111111000000000000000000000000000000000000000001
10000000000000000000001111101111111111110111110000000000000000000000000000000000000000001
10000000000000000000000111101111111111110111100000000000000000000000000000000000000000001
10000000000000000000000000101111111111110100000000000000000000000000000000000000000000001
10000000000000000000000000000111111111100000000000000000000000000000000000000000000000001
10000000000000000000000000000000111100000000000000000000000000000000000000000000000000001
10000000000000000000000000000000011000000000000000000000000000000000000000000000000000001
10000000000000000000000000000000000000000000000000000000000000000000000000000000000000001
10000000000000000000000000000000000000000000000000000000000000000000000000000000000000001
10000000000000000000000000000000000000000000000000000000000000000000000000000000000000001
10000000000000000000000000000000000000000000000000000000000000000000000000000000000000001
10000000000000000000000000000000000000000000000000000000000000000000000000000000000000001
10000000000000000000000000000000000000000000000000000000000000000000000000000000000000001
10000000000000000000000000000000000000000000000000000000000000000000000000000000000000001
10000000000000000000000000000000000000000000000000000000000000000000000000000000000000001
10000000000000000000000000000000000000000000000000000000000000000000000000000000000000001
10000000000000000000000000000000000000000000000000000000000000000000000000000000000000001
10000000000000000000000000000000000000000000000000000000000000000000000000000000000000001
10000000000000000000000000000000000000000000000000000000000000000000000000000000000000001
10000000000000000000000000000000000000000000000000000000000000000000000000000000000000001
10000000000000000000000000000000000000000000000000000000000000000000000000000000000000001
10000000000000000000000000000000000000000000000000000000000000000000000000000000000000001
10000000000000000000000000000000000000000000000000000000000000000000000000000000000000001
10000000000000000000000000000000000000000000000000000000000000000000000000000000000000001
10000000000000000000000000000000000000000000000000000000000000000000000000000000000000001
10000000000000000000000000000000000000000000000000000000000000000000000000000000000000001
10000000000000000000000000000000000000000000000000000000000000000000000000000000000000001
10000000000000000000000000000000000000000000000000000000000000000000000000000000000000001
10000000000000000000000000000000000000000000000000000000000000000000000000000000000000001
10000000000000000000000000000000000000000000000000000000000000000000000000000000000000001
10000000000000000000000000000000000000000000000000000000000000000000000000000000000000001
10000000000000000000000000000000000000000000000000000000000000000000000000000000000000001
10000000000000000000000000000000000000000000000000000000000000000000000000000000000000001
10000000000000000000000000000000000000000000000000000000000000000000000000000000000000001
10000000000000000000000000000000000000000000000000000000000000000000000000000000000000001
10000000000000000000000000000000000000000000000000000000000000000000000000000000000000001
10000000000000000000000000000000000000000000000000000000000000000000000000000000000000001
10000000000000000000000000000000000000000000000000000000000000000000000000000000000000001
10000000000000000000000000000000000000000000000000000000000000000000000000000000000000001
10000000000000000000000000000000000000000000000000000000000000000000000000000000000000001
10000000000000000000000000000000000000000000000000000000000000000000000000000000000000001
10000000000000000000000000000000000000000000000000000000000000000000000000000000000000001
1000000000N000000000000000000000000000000000000000000000000000000000000000000000000000001
10000000000000000000000000000000000000000000000000000000000000000000000000000000000000001
10000000000000000000000000000000000000000000000000000000000000000000000000000000000000001
10000000000000000000000000000000000000000000000000000000000000000000000000000000000000001
10000000000000000000000000000000000000000000000000000000000000000000000000000000000000001
11111111111111111111111111111111111111111111111111111111111111111111111111111111111111111