NO ./textures/jan.png
SO ./textures/jan.png
WE ./textures/jan.png
EA ./textures/jan.png

F 0,0,0
C 255,0,255



11111111111111111111111111
10000000000000000000000001
10000000000000000001111111
10000001000000000001
10000000000000000001
10000000000000000001
11111111111000000001
11110000000000000001
10W00000000000000001
11111111111000000001
11111111111000000001
11111111111000000001
11111111111000000001
11111111111000000001
11111111111000000001
11111111111000000001
11111111111000000001
11111111111000000001
11111111111000000001
11111111111000000001
11111111111000000001
11111111111000000001
11111111111000000001
11111111111000000001
11111111111000000001
11111111111111111111
