NO ./textures/north.png
SO ./textures/south.png
WE ./textures/west.png
EA ./textures/east.png

F 0,0,0
C 255,255,255


1111111111111111111
1E00000000000000001
1011111111111111101
101             101
101             101
101             101
101             101
101             101
101             101
101             101
101             101
101             101
101             101
101             101
1011111111111111101
1000000000000000001
1111111111111111111