NO ./textures/north.png
SO ./textures/south.png
WE ./textures/west.png
EA ./textures/east.png

F 0,0,0
C 255,0,255



1111
1W01
1001
1111
