NO ./textures/roodmuurtje.png
SO ./textures/groenmuurtje.png
WE ./textures/blauwmuurtje.png
EA ./textures/geelmuurtje.png

F asdsada1,0,0
C 255,255,255

11111111111111111111
10000000000000000001
10000000000000000001
10000001000000000001
10000000000000000001
11110000000000000001
1  11111111000000001
11110000000000000001
10W00000000000000001
11111111111111111111
