NO ./textures/roodmuurtje.png
SO ./textures/groenmuurtje.png
WE ./textures/blauwmuurtje.png
EA ./textures/geelmuurtje.png

F 0,0,0
C 255,255,255


1111111111111111111
1E00000 00000000001
1011111111111111101
101             101
101             101
101             101
101             101
101             101
101             101
101             101
101             101
101             101
101             101
101             101
1011111111111111101
1000000000000000001
1111111111111111111