NO ./textures/roodmuurtje.png
SO ./textures/groenmuurtje.png
WE ./textures/blauwmuurtje.png
EA ./textures/geelmuurtje.png

C 255,255,255
F 0,0,0

11111111111111111111
10000000000000000001
10000000000000000001
11111111111111111111
10000001000000000001
10000000000000000001
11111111111111111111
1000000000001    101
1111111111101    101
1111000000001    101
10W0000000001    001
11111111111111111111

